x x x x x x x x x x
x x x x x x x x x x
x x x x x x x x x x
x x x x x x x x x x
x x x s e e e x x x
x x x x x x x x x x
x x x x x x x x x x
x x x x x x x x x x
x x x x x x x x x x
x x x x x x x x x x
x x x x x x x x x x
x x x x x x x x x x
x x x x x e e e x x
x x x x x e x e x x
x x x s e e e e x x
x x x x x x e x x x
x x x x x x e x x x
x x x x x x x x x x
x x x x x x x x x x
x x x x x x x x x x
x x x x x x x x e x
x x x x x x e e e x
x x x x e e e e e x
x x e e e x x x e x
x x e e e s e e e x
x x e e e x x x e x
x x e e e e e e e x
x x x x e e x e e x
x x x x x x x x x x
x x x x x x x x x x
